11111111
1000P111
1C011111
110010E1
11111111