111111111111111111
10E0P0001100C00001
100000001000000001
100000111000000001
100000001000C00001
101111C00000000001
1000C0001001110001
100000011000000001
100001001000000001
100000001000000001
111111111111111111