11111111111111111111111111111
100110000000C0000000001100001
11110000100000000000000000001
11100000000000000000000000001
1000000P000000000100000000001
10000000000000000000000000001
10000000000110000000000100001
10000000000000000000000000001
10000000000001110000000000001
10000000000000000000000000001
1000000000C00C010000000000001
10000000000C000000E0000000001
10000000000000010000000000001
10000C1010101C100000000100001
11111111111111111111111111111