1111111
1111111
1111111
1111111
111P111
11CE111
1111111
1111111
1000011
1111111